
 
NO ./path_to_the_north_texture

C        6        ,  26    , 30  

WE ./path_to_the_west_texture
EA ./path_to_the_east_texture


SO ./path_to_the_south_texture

F 1     ,        5, 3

111111111111111111
1000000000000000011111111111
1011000000000000000000000001
1000110000000000001111111101
1000001100000000001       111
10000001000N000001
100000010000000001
100000000000000001
111111111111111111




        
