
 
NO ./path_to_the_north_texture

C        6        ,  26    , 30  

WE ./path_to_the_west_texture
EA ./path_to_the_east_texture


SO ./path_to_the_south_texture

F 1     ,        5, 3

111111111111111111
100000000000000001  1111
101100000000000001  1001
1000110000000000001 111
1000001100000000001
10000001000W000001
100000010000000001
100000000000000001
111111111111111111




        

