
 
NO ./path_to_the_north_texture

C        255        ,  0    , 0  

WE ./path_to_the_west_texture
EA ./path_to_the_east_texture


SO ./path_to_the_south_texture

F 0     ,        0, 255

111111111111111111
1000000000000000011111111111
1011000000000000000000000001
10001100000000000011111111001
1000001100000000001      1001       111
100000010000000001      1001 
100000010000000001111111001 
10000000000N000000000000001 
111111111111111111111111111 




        
