
 
NO ./path_to_the_north_texture

C        6        ,  26    , 30  

WE ./path_to_the_west_texture
EA ./path_to_the_east_texture


SO ./path_to_the_south_texture

F 1     ,        5, 3

1111111111111111111111111
10000000001111110000000001
10110000011111111110000001
10010000000011110000000001
1111111110111110011100001
100000000011000001110111111111111
11110111111111011100000010001
11110111111111011101010010001
110000001101010111100000010001
100000000000000011100000010001
100000000000000011110100100011
1100000111010101111111110N01101      11
11110111 1110101 10111101000111111
11111111 1111111 1111  1101111101
                         1     11 




        

