
 
NO ./path_to_the_north_texture

C        135, 206, 235

WE ./path_to_the_west_texture
EA ./path_to_the_east_texture


SO ./path_to_the_south_texture

F 204, 78, 42

111111111111111111
1000000000000000011111111111
1011000000000000000000000001
10001100000000000011111111001
1000001100010000001      1001       111
1000001100010000001      1001       111
1000001100010000001      1001       111
1000001100010000001      1001       111
1000001100010000001      1001       111
1000001100010000001      1001       111
1000001100010000001      1001       111
1000001100010000001      1001       111
1000001100010000001      1001       111
1000001100010000001      1001       111
1000001100010000001      1001       111
1000001100010000001      1001       111
1000001100010000001      1001       111
1000001100010000001      1001       111
1000001100010000001      1001       111
1000001100010000001      1001       111
1000001100010000001      1001       111
1000001100010000001      1001       111
1000001100101000001      1001       111
100000110010100001      1001       111
100000010000000001      1001 
100000010000000001111111001 
1000000000N0000000000000001 
111111111111111111111111111 




        
