
 
NO ./textures/north.png

C        135, 206, 235 
WE ./textures/west.png
EA ./textures/east.png


SO ./textures/south.png
F 204, 78, 42

111111111111111111
100000000000000001
100000000000000001
100000000000000001
100000000000000001
100000000N00000001
100000000000000001
100000000000000001
100000000000000001
100000000000000001
111111111111111111



        
