
 
NO ./textures/north.png

WE ./textures/west.png
EA ./textures/east.png


SO ./textures/south.png
F 37, 25, 10
C   20, 35, 37 


111111111111111111
1000000000000000011111111111
10110000000000000000000000001
10001111D1D100000011111110001
1000001100010001010000010001       1111111111
100000110001D1D10010000010001111111110000001
100000110001000000100000100000000000000010101
100000110001010100100000100011111111100000011
100000110001D1000010000010001       1000001
10000011000101010010000010001       1000001
100000110001D1000010000010001       1000001
100000110N0001010010000010001       1000001
100000110000000000000000000001       1000001
100000110001000000111111100001       1000001
100000110001000000100000010001       1000001
10000011000100000010000001000111111111000001
10000011000100000010000001000000000000000001
10000011000100000010000001000111111111000001111111111
100000110001000000100000010001       10000000000000001
100000110010100000100000110001       10000000000000001
100000110010100001011111110001       1111111111111111
100000000000000000000000000001
11111111111111111111111111111



        
