
 
NO ./textures/north.png

C        135, 206, 235 
WE ./textures/west.png
EA ./textures/east.png


SO ./textures/south.png
F 204 , 78, 42

111
111111111111111111
1000000000000000011111111111
10110000000000000000000000001
10001100000000000011111110001
1000001100010000010000010001       1111111
1000001100010000001000001000111111111000101
1000001100010000001000001000000000000000001
1000001100010000001000001000111111111000101
10000011000100000010000010001       10S0001
10000011000100000010000010001       1000001
10000011000100000010000010001       1000001
10000011000100000010000010001       1000001
100000110001000000000000000001       1000001
100000110001000000111111100001       1000001
100000110001000000100000010001       1000001
10000011000100000010000001000111111111000001
10000011000100000010000001000000000000000001
10000011000100000010000001000111111111000001111111111
100000110001000000100000010001       10000000000000001
100000110010100000100000110001       10000000000000001
100000110010100001011111110001       1111111111111111
100000000000000000000000000001
11111111111111111111111111111



        
