NO ./textures/north.png

WE ./textures/west.png
EA ./textures/east.png


SO ./textures/south.png
F 37, 25, 10
C   20, 35, 37 

11111111111111111111111111111111111111111111111111111111111111111111111111111111111111111111
11100000000000000000000000100000000000000100000000000000000000000000000000000000000000000001
10000000000000000000000011000000000000001000000000000000000000000000000000000000000000000001
10000000000000000000000011000000000000001000000000000000000000000000000000000000000000000001
11111111100000000111111110000001000000100000011111111110000000011111111100000000000000000001
11111111110000001111111111000001100000100000111111111110000011111111110000000000000000000001
10000000000000001000000000000001100000000000000100000110000000000000010000000000000000000001
10000000000000001000000000000001100000000000000100000110000000000000010000000000000000000001
10000000000000001000000000000001100000000000000100000110000000000000010000000000000000000001
10000000111111111000000111111111111111111111111111111000001111111111000000100000000000000001
10000001111111111110000001111111111111111111111111111110000011111111111100000010000000000001
10000000000000000000000000000000011000001100000000000000000000000000000000100000000000000001
10000000000000000000000000000000011000001000000000000000000000000000000001000000000000000001
10000000000000000000000000000000011000001000000000000000000000000000000001000000000000000001
11111111111111111111111111111111111000001111111111000000000000000001111111111111111111111111
11111111111111111111111111111111111111100000111111111111100000111111111111111111111111111111
10000001000000000000001100000000000000000000000100000000000000100000000000000000000000000001
10000001000000000000001100000000000000000000000100000000000000D00000000000000000000000000001
10000001000000000000001100000000000000000000000100000000000000100000000000000000000000000001
10000001000000000000001100000011111111111111D11101111111011111111111111111111111100000000001
10000001000000000000001100000011111111110000010000011000000110000001000000000000000000000001
10000001000000000000001100000000000000100000100000110000000000000010000000000000000000000001
10000001000000000000001100000000000000100000100000110000000000000010000000000000000000000001
10000001000000000000001100000000000000100000100000110000000000000010000000000000000000000001
100000011111D111000111111111111111D1110000001010011111111111111111110011111111111111111D1111
10000001110000001000000111111111110100001000001000001111111111111111111000000000000000000001
10000000000000001000000000000000000000001000001000001100000000000000100000000000000000000001
10000000000000001000000000000000000000001000001000001100000000000000100000111111111111111111
10000000000000001000000000000000000000001111111100001100000000000000100000000000000000000001
111111111100000010000011000001100000100000100000111111111100000011D1100000000000000000000001
11111111110000001000001100000110000010000010000001111111111100001000000000000000000000000001
10000000010000001000001100000110000010000010000000000000010000001000000000000000000000000001
10000000010000001000001100000110000010000010000000000000010000001000000000000000000000000001
10000000010000001000001111000001100000100000100000000000000000001111111111111111111111111111
11D11111111111110000011111111111111111111111111111111110000010000001000000000000000000000001
10000001000011000000000000001100000100000110000000001000000000000000000000000000000000000001
10000001000000100000000000000110000010000010000000001000000000000000000000000000000000000001
10000001000000100000000000000110000010000010000000001000000000000000000000000000000000000001
10000001000000111111100000001100000100000100000001111111111111111110001111111111111111111111
10000001000000111111111100000110000010000010000011111111111111111110000000000000000000000001
10000000000000001000001100000110000000000000010000011000000000000001000000000000000000000001
10000000000S00001000001100000110000000000000010000011000000000000001000000000000000000000001
100000000000000010000011000001100000000000010100011111D1000000000001000000000000000000000001
11111111100000001001D11101D10110001111111111D11110000001000000110000001000000000000000000001
11111111111D11111111011111011111D110111111100011100000011111111111111111111111111D1111111111
10000000000000000000000000000000011000000000000000000000001100000100000000000000101000000001
10000000000000000000000000000000011000000000000000000000001100000100000000000000101000000001
10000000000000000000000000000000000000000000000000000000000000000000000000000000000000000001
11111111111111111111111111111111111111111111111111111111111111111111111111111111111111111111