


 
NO ./textures/north.png

WE ./textures/west.png
EA ./textures/east.png


SO ./textures/south.png
F 37, 25, 10
C   20, 35, 37 



111111111111111111111111111111111111111111111111111111111111111111111111
110000000000000000000001110000000000000000000000000000000000000000000101
100000000000000000000001100000000000000000000000000000000000000000000001
100011111111100111111111111111111100011111111111111111111000111111100001
100011000000000000000000000000000000000000001100000000000000000000100001
100011111111111111111111110011111111111111111111111111111111111001100001
100011001100000011000000000000000000000000000000000000000000011111100001
100011001100111111111111111111111111111100111111111111111110011001100001
110011001100110000000000000000000000000000000110000000000000011000111111
100000000000110011111111111111111111111111111111111111111111111000000101
100011111100110011000000000000111000000000000000000001100000011000100001
100011001100110111000000000000111000000000000000000001100000011000100001
111111001100111111001111111100011111001111111111111001100110011000100001
110111001100000000001100110000000000001100000000011001100110000000100001
100011001100111111001100111111111111111111111110011000000110011000111111
100000001111110011000000000000000000000000000110011111100111111000110101
100011001100110011000000000011111111111111100110011001100000011101100001
100011001100110011111111110011000000000001100110011001100000011111100001
100011000000110000000000111111001111111001111110011001100110011000000001
100011111000000011111100110000001110111111100110011001111110000000100001
100011001100110011001100110011001111111011100000011001100111111000111111
100011001100110011001100000011000111110001100000011001100000011111111111
100011001111111111001111110011100000000011100110011000000111111001100001
100011001100110011001100110011111111111111100110011001100110011000100001
100000000000110011001100110000000000000000000110011001100110011000100001
111110001100110011001100111111111111111111111111111001111110011000100001
111111001100000011000000000000000000000000000000000001111110000000100001
100011001111110011001111111111111111111111111111111001100110011111100001
100011111100110000000000000000000000000000011000000001100110011000000001
100000001100110011111111111111111111110011111111111111100110011000100001
100010001100110000000000000000011110000000000000000000000110011000111111
100011001000110000000000000000011110000000000000000000000110000000111111
100011000000111111111111111111111111111111111111111111111110011000100001
100011001100000000000000000000000000000011000000000000000000011001100001
100011111111111111111111111111111111001111111111100111111111111111100001
100011000000000000000000000001100000000000000000000000000000000000100001
100011111111011111111110011111111111111111111111111111111110011111100001
1N0000000000000000011000000000000000000000000000011000000000000000000001
111111111111111111111111111111111111111111111111111111111111111111111111