NO ./textures/north.png

WE ./textures/west.png
EA ./textures/east.png


SO ./textures/south.png
F 37, 25, 10
C   20, 35, 37 


111111111111111
100000000000001
100000000000001
1111111D1111111
100000000000001
1000000N0000001
100000000000001
100000000000001
100000000000001
100000000000001
111111111111111